################################       ################
##                            ##       ##            ##
##                            ##       ##  @         ##
##         i                  ##       ##            ##
##                        ##  ##       ##            ##
##         *              ##  ##       ############  ##
##                        ##  ##                 ##  ##
##                        ##  ##                 ##  ##
############################  ##                 ##  ##
                          ##  ##                 ##  ##
         ###################  #####################  ##
         ##                          ##          ##  ##
         ##          *        #####  ##############  ##
         ##                   ## ##                  ##
         ##     i             ## ##     *          i ##
         ##                   ## ##                  ##
         ####################### ##                  ##
         ##                      ##                  ##
         ##                      ##                  ##
         ##                      ##                  ##
         ##     *                ##                  ##
         ##                      ##     i          * ##
         ##                      ##                  ##
         ##                                          ##
         ##############################################
