                   ########
                   ##  @ ##
                   ##    ##
                   ##    ##
   ##################    ###########################
   ##                                             ##
   ##              ##        *                    ##
   ##              ##                             ##
   ##   i          ##                             ##
   ##         *    ##              i              ##
   ##              ##                             ##
   ##              ##                             ##
   ###########################   ###################
                            ##   ##
                            ##   ##
                            ##   ##
                            ##   ##
                            ##   ##
                            ##   ##
                            ##   ###################
   ###########################                    ##
   ##                                             ##
   ##                         #####               ##
   ##              *          ##                  ##
   ##                         ##                  ##
   ##     i                   ##     *       i    ##
   ##                         ##                  ##
   ##                         ##                  ##
   #################################################
